vehicle_id,stop_time,dep_time,arr_time,drive_time,occupancy
148,600,320,1136,816,0
20,600,560,3941,3381,0
14,600,1210,4367,3157,0
3,600,840,4371,3531,0
92,600,720,4689,3969,0
148,600,1736,9700,7964,1
162,600,7260,10136,2876,0
14,600,4967,11044,6077,1
3,600,4971,11523,6552,1
92,600,5289,14645,9356,1
20,600,4541,16393,11852,1
148,600,16600,16600,0,0
92,600,16840,16840,0,0
3,600,12123,19007,6884,1
71,600,23360,23593,233,0
28,600,22340,24213,1873,0
148,600,17200,25426,8226,1
92,600,17440,26312,8872,1
161,600,24190,26445,2255,0
65,600,24850,27298,2448,0
28,600,24813,28489,3676,1
14,600,28750,28750,0,0
150,600,27230,32045,4815,0
174,600,32870,32870,0,0
161,600,27045,32888,5843,1
101,600,31530,33931,2401,0
71,600,24193,34532,10339,1
65,600,27898,35446,7548,1
14,600,29350,35624,6274,1
150,600,32645,36203,3558,1
162,600,10736,36233,25497,1
55,600,34740,36426,1686,0
199,600,34440,36928,2488,0
14,600,36224,36968,744,0
185,600,36110,37643,1533,0
161,600,38270,38270,0,0
28,600,35060,39172,4112,0
55,600,37026,40021,2995,1
101,600,34531,40121,5590,1
58,600,38580,40147,1567,0
141,600,37390,40533,3143,0
24,600,37390,40884,3494,0
174,600,33470,41115,7645,1
199,600,37528,41877,4349,1
14,600,37568,42022,4454,1
55,600,42410,42410,0,0
199,600,42980,42980,0,0
28,600,39772,43612,3840,1
161,600,38870,43655,4785,1
185,600,38243,44003,5760,1
150,600,36803,44077,7274,1
71,600,44280,44280,0,0
1,600,41850,44643,2793,0
174,600,45680,45680,0,0
55,600,43010,46003,2993,1
14,600,46470,46470,0,0
199,600,43580,47807,4227,1
24,600,41484,48269,6785,1
1,600,45243,48429,3186,1
64,600,44410,51205,6795,0
150,600,44677,51211,6534,1
14,600,47070,51404,4334,1
181,600,48310,51539,3229,0
1,600,49029,52140,3111,1
174,600,46280,53890,7610,1
191,600,49630,54143,4513,0
160,600,52750,54526,1776,0
71,600,44880,55327,10447,1
101,600,56230,56230,0,0
24,600,48869,56251,7382,1
193,600,54230,56819,2589,0
58,600,40747,56962,16215,1
64,600,51805,57214,5409,1
69,600,55290,58726,3436,0
160,600,55126,58881,3755,1
141,600,41133,60616,19483,1
150,600,51811,61531,9720,1
167,600,58930,61778,2848,0
193,600,57419,62085,4666,1
101,600,56830,62520,5690,1
185,600,63380,63380,0,0
64,600,57814,63721,5907,1
191,600,54743,65295,10552,1
181,600,52139,65651,13512,1
69,600,59326,68317,8991,1
83,600,66420,68953,2533,0
113,600,65690,69378,3688,0
176,600,65780,69460,3680,0
191,600,70270,70270,0,0
185,600,63980,70684,6704,1
167,600,62378,73447,11069,1
176,600,70060,77417,7357,1
69,600,68917,77625,8708,1
167,600,78170,78170,0,0
181,600,66251,80566,14315,1
83,600,69553,82052,12499,1
191,600,70870,82319,11449,1
197,600,81720,82822,1102,0
176,600,78017,83829,5812,1
83,600,82652,85681,3029,1
176,600,84429,88665,4236,0
41,600,87140,88743,1603,0
167,600,78770,89933,11163,1
197,600,83422,90605,7183,1
55,600,88970,92886,3916,0
113,600,69978,93322,23344,1
3,600,91360,93831,2471,0
116,600,91240,94291,3051,0
176,600,89265,95816,6551,1
167,600,91810,96035,4225,0
108,600,95340,97062,1722,0
116,600,94891,97225,2334,1
41,600,89343,97593,8250,1
197,600,96640,98040,1400,0
77,600,97110,98338,1228,0
181,600,97550,98632,1082,0
30,600,95630,98797,3167,0
83,600,86281,99733,13452,1
55,600,93486,99844,6358,1
3,600,94431,100894,6463,1
161,600,98800,101103,2303,0
108,600,97662,101670,4008,1
176,600,96416,102562,6146,1
116,600,103480,103480,0,0
167,600,96635,104158,7523,1
28,600,106090,106090,0,0
108,600,102270,106263,3993,1
116,600,104080,106475,2395,1
77,600,98938,107959,9021,1
181,600,99232,108425,9193,1
3,600,108440,108440,0,0
55,600,108500,108500,0,0
126,600,104570,109393,4823,0
153,600,106290,109532,3242,0
28,600,106690,110402,3712,1
167,600,104758,112256,7498,1
161,600,101703,114000,12297,1
41,600,114390,114390,0,0
153,600,110132,115534,5402,1
30,600,99397,115670,16273,1
3,600,109040,115731,6691,1
55,600,109100,115977,6877,1
181,600,116330,116330,0,0
108,600,113490,117199,3709,0
29,600,116500,118188,1688,0
45,600,116560,118481,1921,0
160,600,118650,119664,1014,0
197,600,98640,120118,21478,1
88,600,119300,120358,1058,0
124,600,117350,120786,3436,0
126,600,109993,121353,11360,1
160,600,120264,122822,2558,1
58,600,122000,123324,1324,0
77,600,123520,123520,0,0
41,600,114990,123683,8693,1
181,600,116930,123852,6922,1
5,600,120450,123936,3486,0
107,600,121560,124025,2465,0
124,600,121386,124254,2868,1
39,600,123410,124254,844,0
185,600,122090,124260,2170,0
53,600,123510,125294,1784,0
108,600,117799,125855,8056,1
29,600,118788,126069,7281,1
88,600,120958,126072,5114,1
134,600,123990,126425,2435,0
119,600,125020,126585,1565,0
58,600,123924,127002,3078,1
195,600,122750,127404,4654,0
153,600,127660,127660,0,0
53,600,125894,128035,2141,1
5,600,124536,128492,3956,1
39,600,124854,129011,4157,1
45,600,119081,129573,10492,1
77,600,124120,130243,6123,1
23,600,127600,130566,2966,0
124,600,131370,131370,0,0
168,600,131590,131590,0,0
45,600,131610,131610,0,0
54,600,127630,131634,4004,0
134,600,127025,131728,4703,1
119,600,127185,132200,5015,1
187,600,131840,132837,997,0
153,600,128260,133867,5607,1
119,421,132621,134316,1695,1
116,600,133790,134423,633,0
86,600,133030,134470,1440,0
124,600,131970,135079,3109,1
73,600,132570,135124,2554,0
119,600,134916,135679,763,2
54,600,132234,135934,3700,1
98,600,132950,135986,3036,0
150,600,132190,136126,3936,0
185,600,124860,136247,11387,1
122,600,135210,137092,1882,0
51,600,130630,137217,6587,0
73,600,135724,137404,1680,1
168,600,132190,137561,5371,1
107,600,124625,137945,13320,1
39,600,138780,138780,0,0
195,600,128004,138894,10890,1
44,600,138200,138993,793,0
161,600,139580,139580,0,0
119,600,136279,139682,3403,1
23,600,131166,139927,8761,1
187,600,133437,140154,6717,1
134,600,140470,140470,0,0
176,600,135770,140905,5135,0
54,600,141050,141050,0,0
125,600,137140,141845,4705,0
29,600,142000,142000,0,0
50,600,138390,142077,3687,0
138,600,139040,142089,3049,0
98,600,136586,142184,5598,1
150,600,136726,142369,5643,1
22,600,140450,142605,2155,0
23,600,142740,142740,0,0
160,600,141490,143047,1557,0
116,600,135023,143430,8407,1
119,600,140282,143889,3607,1
29,600,142600,143892,1292,1
86,600,135070,144038,8968,1
54,600,141650,144311,2661,1
14,600,141370,144440,3070,0
141,600,144440,144440,0,0
126,600,144690,144690,0,0
29,600,144720,144720,0,0
73,600,138004,145165,7161,2
134,600,141070,145362,4292,1
44,600,139593,145878,6285,1
138,600,142689,146108,3419,1
142,600,145340,146146,806,0
116,66,143496,146386,2890,1
45,600,132210,147157,14947,1
176,600,141505,147235,5730,1
86,600,147540,147540,0,0
150,600,147770,147770,0,0
143,600,144700,148155,3455,0
125,600,142445,148308,5863,1
186,600,145460,148313,2853,0
39,600,139380,148484,9104,1
159,600,142050,148551,6501,0
51,600,137817,148825,11008,1
182,600,148350,149484,1134,0
168,600,149490,149490,0,0
73,600,145765,149526,3761,1
142,600,146746,149796,3050,1
70,600,149020,150150,1130,0
124,600,147060,150161,3101,0
160,600,143647,150204,6557,1
103,600,147430,150283,2853,0
116,600,146986,150316,3330,2
22,600,143205,150445,7240,1
122,600,137692,150588,12896,1
187,600,150660,150660,0,0
113,600,149250,151956,2706,0
107,600,138545,152083,13538,1
141,600,145040,152219,7179,1
1,600,148520,152273,3753,0
112,600,150350,152312,1962,0
22,600,152420,152420,0,0
197,600,152550,152550,0,0
159,600,149151,153096,3945,1
193,600,153370,153370,0,0
54,600,147910,153593,5683,0
7,600,148620,153713,5093,0
23,600,143340,153872,10532,1
73,600,152180,154056,1876,0
14,600,145040,154123,9083,1
70,600,150750,154225,3475,1
45,600,147757,154270,6513,1
39,600,150070,154453,4383,0
150,600,148370,154489,6119,1
63,600,150670,154945,4275,0
168,600,150090,154978,4888,1
182,600,150084,155236,5152,1
186,600,148913,155413,6500,1
116,600,150916,155563,4647,1
166,600,151280,155750,4470,0
22,600,153020,155860,2840,1
1,600,152873,155948,3075,1
176,600,155740,156270,530,0
160,600,150804,156552,5748,1
52,600,154150,156611,2461,0
192,600,152680,156615,3935,0
103,600,150883,156682,5799,1
169,600,154440,156705,2265,0
161,600,140180,156750,16570,1
126,600,145290,156862,11572,1
125,600,156870,156870,0,0
50,600,142677,157006,14329,1
124,600,150761,157036,6275,1
159,600,154100,157216,3116,0
187,600,151260,157224,5964,1
86,600,148140,157308,9168,1
109,600,151620,157349,5729,0
92,600,153470,157544,4074,0
119,600,156840,157603,763,0
79,600,153550,157687,4137,0
113,600,152556,157848,5292,1
135,600,154130,157872,3742,0
122,600,158180,158180,0,0
7,600,154313,158236,3923,1
153,600,156560,158456,1896,0
168,600,155578,158572,2994,0
6,600,153900,158665,4765,0
109,600,157949,159350,1401,1
54,600,154193,159433,5240,1
39,600,155053,159474,4421,1
193,600,153970,159713,5743,1
141,600,159800,159800,0,0
169,600,157305,159823,2518,1
63,600,155545,160389,4844,1
92,600,158144,160533,2389,1
148,600,158860,160673,1813,0
73,600,154656,160858,6202,1
19,600,156620,160977,4357,0
182,600,156820,161301,4481,0
159,600,157816,161545,3729,1
116,600,161790,161790,0,0
29,600,145320,162256,16936,1
119,600,158203,162326,4123,1
168,600,159172,162495,3323,1
143,600,148755,162543,13788,1
186,600,156013,162566,6553,1
109,600,159950,162877,2927,0
188,600,158110,163008,4898,0
77,600,163090,163090,0,0
47,600,159860,163145,3285,0
33,600,161480,163276,1796,0
125,600,157470,163814,6344,1
135,600,158472,164100,5628,1
152,600,159110,164201,5091,0
51,600,159480,164228,4748,0
73,600,161458,164298,2840,0
68,600,160460,164473,4013,0
148,600,161273,164609,3336,1
79,600,158287,164610,6323,1
87,600,159400,164904,5504,0
107,600,158090,164933,6843,0
133,600,164340,165220,880,0
63,600,160989,165265,4276,1
159,600,162145,165469,3324,0
176,600,156870,165545,8675,1
106,600,159910,165608,5698,0
126,600,161040,165611,4571,0
46,600,159970,165650,5680,0
166,600,156350,165668,9318,1
39,600,162910,165730,2820,0
112,600,152912,166124,13212,1
9,600,164060,166384,2324,0
176,600,166770,166770,0,0
52,600,157211,166979,9768,1
29,600,167130,167130,0,0
1,600,167280,167280,0,0
45,600,162560,167413,4853,0
47,600,163745,167530,3785,1
138,600,167590,167590,0,0
182,600,161901,167785,5884,1
92,600,167880,167880,0,0
87,600,165504,168218,2714,1
160,600,165470,168286,2816,0
63,600,165890,169187,3297,0
6,600,159265,169449,10184,1
54,600,169830,169830,0,0
19,600,161577,169941,8364,1
152,600,164801,170003,5202,1
9,600,166984,170119,3135,1
51,600,164828,170163,5335,1
39,600,166330,170173,3843,1
125,600,165510,170568,5058,0
92,600,168480,170770,2290,1
77,600,163690,170783,7093,1
1,600,167880,170888,3008,1
107,600,165533,171165,5632,1
138,600,168190,171280,3090,1
153,600,159056,171361,12305,1
77,600,171580,171580,0,0
9,600,171600,171600,0,0
89,600,167700,171685,3985,0
73,600,164898,171868,6970,1
168,600,172020,172020,0,0
40,600,167870,172113,4243,0
58,600,171820,172124,304,0
122,600,158780,172219,13439,1
134,600,170680,172297,1617,0
133,600,165820,172517,6697,1
36,600,167730,172534,4804,0
192,600,157215,172664,15449,1
160,600,168886,172705,3819,1
112,600,170330,172723,2393,0
96,600,166730,172924,6194,0
37,600,167060,173038,5978,0
90,600,167660,173269,5609,0
19,600,173560,173560,0,0
68,600,165073,173572,8499,1
159,600,166069,173834,7765,1
197,600,153150,173980,20830,1
103,600,174400,174400,0,0
33,600,163876,174435,10559,1
94,600,171170,174447,3277,0
46,600,166250,174642,8392,1
125,600,171168,174719,3551,1
70,600,173370,174814,1444,0
98,600,174820,174820,0,0
188,600,163608,174877,11269,1
52,600,174260,174968,708,0
189,600,173200,175177,1977,0
9,600,172200,175198,2998,1
126,600,166211,175321,9110,1
190,600,170960,175560,4600,0
69,600,172300,175609,3309,0
124,600,170660,175662,5002,0
47,600,172070,175712,3642,0
116,600,162390,175862,13472,1
168,600,172620,175967,3347,1
45,600,168013,176029,8016,1
101,600,173540,176196,2656,0
63,600,169787,176223,6436,1
50,600,173510,177159,3649,0
54,600,170430,177283,6853,1
161,600,177490,177490,0,0
148,600,173130,177526,4396,0
42,600,174450,177562,3112,0
28,600,175080,177673,2593,0
193,600,175330,177861,2531,0
46,600,177870,177870,0,0
58,600,172724,177979,5255,1
141,600,160400,178061,17661,1
36,600,173134,178130,4996,1
33,600,175400,178130,2730,0
176,600,167370,178360,10990,1
19,600,174160,178712,4552,1
52,600,175568,178987,3419,1
68,600,179070,179070,0,0
109,600,163477,179090,15613,1
77,600,172180,179173,6993,1
71,600,177910,179472,1562,0
90,600,173869,179517,5648,1
101,600,176796,179548,2752,1
112,600,173323,179905,6582,1
87,600,176650,179919,3269,0
132,600,177650,180008,2358,0
79,600,176710,180166,3456,0
68,600,179670,180217,547,1
96,600,173524,180324,6800,1
101,600,180360,180360,0,0
26,600,178240,180399,2159,0
190,600,176160,180447,4287,1
186,600,180090,180465,375,0
29,600,167730,180861,13131,1
39,600,180920,180920,0,0
189,600,175777,180993,5216,1
166,600,181110,181110,0,0
98,600,175420,181391,5971,1
160,600,179270,181419,2149,0
112,600,181440,181440,0,0
106,600,166208,181797,15589,1
53,600,179460,181867,2407,0
192,600,177870,181998,4128,0
69,600,176209,182316,6107,1
33,600,178730,182319,3589,1
193,600,178461,182384,3923,1
37,600,173638,182480,8842,1
119,600,182580,182580,0,0
46,600,178470,182597,4127,1
32,600,182770,182770,0,0
96,600,180924,183069,2145,0
197,600,179910,183124,3214,0
124,600,176262,183141,6879,1
40,600,172713,183426,10713,1
125,600,178330,183546,5216,0
14,600,182420,183551,1131,0
92,600,180550,183560,3010,0
101,600,180960,183618,2658,1
89,600,172285,183619,11334,1
159,600,174434,183733,9299,1
70,600,175414,183779,8365,1
47,600,176312,184114,7802,1
42,600,178162,184159,5997,1
45,600,176629,184171,7542,1
106,600,184210,184210,0,0
9,600,182370,184425,2055,0
103,600,175000,184572,9572,1
193,600,184710,184710,0,0
190,600,184770,184770,0,0
52,600,182090,184848,2758,0
135,600,184890,184890,0,0
132,600,180608,184897,4289,1
148,600,178126,184974,6848,1
169,600,177560,185088,7528,0
39,600,181520,185226,3706,1
90,600,180117,185588,5471,1
134,600,172897,185911,13014,1
189,600,183020,186098,3078,0
50,1553,178712,186138,7426,2
73,600,183990,186424,2434,0
53,600,182467,186451,3984,1
41,600,183970,186570,2600,0
79,600,180766,186668,5902,1
1,600,184160,186684,2524,0
192,600,182598,186707,4109,1
46,600,186760,186760,0,0
71,600,180072,186832,6760,1
161,600,178090,186974,8884,1
103,600,187120,187120,0,0
143,600,187380,187380,0,0
133,600,185110,187441,2331,0
123,600,185950,187785,1835,0
86,600,187540,187845,305,0
45,600,185220,187960,2740,0
9,600,185025,188118,3093,1
197,600,183724,188456,4732,1
127,600,183660,188476,4816,0
135,600,185490,188511,3021,1
118,600,183470,188542,5072,0
125,600,184146,188607,4461,1
51,600,182800,188633,5833,0
39,600,188330,188880,550,0
112,600,182040,188966,6926,1
69,600,182916,189061,6145,1
199,600,188280,189197,917,0
185,600,185660,189309,3649,0
68,600,185600,189309,3709,0
73,600,187024,189328,2304,1
70,600,189330,189330,0,0
169,600,185688,189472,3784,1
55,600,184340,189534,5194,0
11,600,182010,189623,7613,0
131,600,184560,189861,5301,0
187,600,187120,190041,2921,0
68,600,189909,190090,181,1
45,600,188560,190137,1577,1
14,600,184151,190227,6076,1
190,600,185370,190420,5050,1
166,600,181710,190510,8800,1
23,600,186830,190529,3699,0
46,600,187360,190662,3302,1
123,600,188385,190713,2328,1
5,600,190730,190730,0,0
28,600,178273,191100,12827,1
150,600,186320,191141,4821,0
79,600,188070,191152,3082,0
87,600,180519,191375,10856,1
107,600,188580,191533,2953,0
106,600,184810,191555,6745,1
159,600,184333,191562,7229,0
120,600,188290,191712,3422,0
37,600,183080,191928,8848,1
9,600,188718,191938,3220,1
121,600,186290,191962,5672,0
86,600,188445,192060,3615,1
147,600,185860,192104,6244,0
22,600,191400,192199,799,0
193,600,185310,192250,6940,1
53,600,192370,192370,0,0
58,600,189860,192581,2721,0
50,600,186738,192582,5844,1
94,600,175047,192609,17562,1
1,600,187284,192640,5356,1
64,600,190310,192645,2335,0
57,600,189300,192648,3348,0
83,600,191770,192673,903,0
168,600,190070,192800,2730,0
190,600,191020,192806,1786,0
191,600,188720,192814,4094,0
65,600,192400,193042,642,0
161,600,190490,193168,2678,0
50,600,193220,193220,0,0
51,600,189233,193224,3991,1
19,600,192550,193540,990,0
134,600,193620,193620,0,0
187,600,190641,193867,3226,1
103,600,187720,193924,6204,1
195,600,189240,193967,4727,0
167,600,190740,193998,3258,0
69,600,191990,194008,2018,0
193,600,194020,194020,0,0
39,600,189480,194095,4615,1
192,600,194120,194120,0,0
89,600,184219,194199,9980,1
55,600,190134,194202,4068,1
28,169,191269,194210,2941,1
52,600,185448,194233,8785,1
42,600,194260,194260,0,0
98,600,189250,194333,5083,0
68,51,190141,194441,4300,1
152,600,191270,194510,3240,0
131,600,190461,194520,4059,1
119,600,183180,194728,11548,1
86,0,192060,194842,2782,1
118,600,189142,194859,5717,1
101,600,192750,194951,2201,0
102,600,190500,194982,4482,0
14,600,192440,195003,2563,0
94,600,195260,195260,0,0
41,600,187170,195277,8107,1
134,600,194220,195290,1070,1
121,600,192562,195300,2738,1
39,600,195480,195480,0,0
11,600,190223,195485,5262,1
36,600,178730,195510,16780,1
145,600,193350,195559,2209,0
5,600,191330,195574,4244,1
176,600,189970,195657,5687,0
120,600,192312,195688,3376,1
87,600,194610,195707,1097,0
92,600,184160,195730,11570,1
143,600,187980,195876,7896,1
133,600,188041,195886,7845,1
60,600,192870,196027,3157,0
199,600,189797,196090,6293,1
185,600,189909,196091,6182,1
107,600,192133,196322,4189,1
160,600,182019,196330,14311,1
23,600,191129,196353,5224,1
26,600,180999,196382,15383,1
58,600,193181,196395,3214,1
37,600,193840,196433,2593,0
96,600,183669,196726,13057,1
190,600,193406,196788,3382,1
12,600,193050,196808,3758,0
124,600,193770,196860,3090,0
160,87,196417,196902,485,1
69,600,194608,196942,2334,1
53,600,192970,197057,4087,1
106,600,192155,197071,4916,0
71,600,194660,197204,2544,0
28,600,194810,197251,2441,2
95,600,193410,197323,3913,0
90,600,194110,197350,3240,0
183,600,190730,197354,6624,0
118,600,195459,197440,1981,0
2,600,193980,197447,3467,0
77,600,195520,197505,1985,0
176,600,196257,197531,1274,1
40,600,192880,197540,4660,0
161,600,193768,197576,3808,1
153,600,195760,197590,1830,0
23,600,197610,197610,0,0
79,600,191752,197656,5904,1
1,600,193600,197843,4243,0
126,600,194860,197884,3024,0
197,600,192780,197887,5107,0
186,600,181065,197906,16841,1
63,600,195030,197936,2906,0
162,600,195880,197953,2073,0
188,600,193580,197960,4380,0
70,600,189930,198024,8094,1
20,600,196450,198068,1618,0
187,600,198160,198160,0,0
14,600,195603,198227,2624,1
31,600,195410,198254,2844,0
168,600,193400,198304,4904,1
152,600,195110,198785,3675,1
86,600,195442,198833,3391,2
103,600,194524,198847,4323,0
30,600,194690,198865,4175,0
195,600,194567,198896,4329,1
75,600,197010,198933,1923,0
192,600,194720,198978,4258,1
46,600,199300,199300,0,0
39,600,196080,199334,3254,1
19,600,194140,199355,5215,1
134,111,195401,199367,3966,1
4,600,193250,199426,6176,0
186,600,198506,199450,944,1
63,600,198536,199450,914,1
164,600,195500,199515,4015,0
125,600,196860,199529,2669,0
55,600,196700,199609,2909,0
51,600,196680,199668,2988,0
21,600,194920,199731,4811,0
58,600,196995,199755,2760,0
162,600,198553,199780,1227,1
40,600,198140,199784,1644,1
50,600,193820,199833,6013,1
195,600,199850,199850,0,0
101,600,195551,199964,4413,1
148,600,195800,199995,4195,0
150,6390,197531,200003,2472,2
45,600,192180,200027,7847,0
175,600,198120,200102,1982,0
98,600,194933,200115,5182,1
142,600,194970,200134,5164,0
106,2263,199334,200194,860,2
121,600,195900,200273,4373,0
125,600,200129,200320,191,1
109,600,199100,200442,1342,0
41,600,196430,200570,4140,0
43,600,194130,200570,6440,0
166,600,198490,200578,2088,0
69,600,198690,200620,1930,0
149,600,198630,200621,1991,0
143,600,196476,200630,4154,1
193,600,194620,200650,6030,1
122,600,196340,200761,4421,0
178,600,195640,200801,5161,0
52,600,197190,200818,3628,0
77,600,198105,200866,2761,1
68,600,195041,200980,5939,2
6,600,201080,201080,0,0
152,600,199385,201086,1701,0
133,600,196486,201092,4606,0
47,600,197650,201320,3670,0
199,17,196107,201355,5248,1
127,600,189076,201407,12331,1
67,600,195690,201446,5756,0
120,600,196288,201446,5158,0
126,600,198484,201456,2972,1
191,600,193414,201457,8043,1
14,600,198827,201482,2655,0
37,600,197033,201489,4456,1
97,600,197260,201521,4261,0
166,600,201178,201570,392,1
183,600,197954,201625,3671,1
112,600,199280,201659,2379,0
39,600,199934,201678,1744,0
170,600,200830,201752,922,0
64,600,193245,201753,8508,1
48,600,195480,201772,6292,0
63,101,199551,201784,2233,1
101,600,200910,201939,1029,0
42,600,194860,201952,7092,1
123,600,195870,202007,6137,0
103,600,199447,202188,2741,1
185,600,196691,202196,5505,0
31,600,198854,202200,3346,1
69,600,201220,202200,980,1
87,600,196307,202211,5904,1
26,600,197210,202242,5032,0
23,600,198210,202277,4067,1
11,600,202290,202290,0,0
46,600,199900,202378,2478,1
92,600,196330,202380,6050,1
50,600,200610,202409,1799,0
118,600,198040,202428,4388,1
183,600,202225,202450,225,1
187,600,198760,202452,3692,1
91,600,197480,202503,5023,0
78,600,198290,202511,4221,0
162,49,199829,202600,2771,1
181,600,201470,202641,1171,0
196,600,196850,202705,5855,0
9,600,197190,202711,5521,0
107,600,202760,202760,0,0
109,600,201042,202868,1826,1
58,600,200355,202889,2534,1
90,600,197950,202929,4979,1
116,600,200130,202957,2827,0
161,600,199590,203018,3428,0
75,600,199533,203049,3516,1
77,600,201466,203126,1660,0
160,600,197502,203130,5628,2
112,600,202259,203157,898,1
141,600,198700,203189,4489,0
86,600,199433,203213,3780,2
62,600,201390,203236,1846,0
76,600,197290,203360,6070,0
69,100,202300,203537,1237,1
32,600,183370,203547,20177,1
164,600,200115,203560,3445,1
143,5,200635,203585,2950,1
125,195,200515,203591,3076,1
147,600,192704,203607,10903,1
123,600,202607,203750,1143,1
65,600,193642,203759,10117,1
134,600,199967,203775,3808,2
133,600,201692,203814,2122,1
186,31,199481,203824,4343,1
167,600,194598,203930,9332,1
135,600,200560,203953,3393,0
193,63,200713,204049,3336,1
79,600,198256,204136,5880,1
188,600,198560,204170,5610,1
124,600,197460,204320,6860,1
108,600,202470,204328,1858,0
148,600,200595,204348,3753,1
63,600,202384,204350,1966,2
70,600,201200,204374,3174,0
164,600,204390,204390,0,0
21,600,200331,204442,4111,1
12,600,197408,204457,7049,1
33,600,199600,204488,4888,0
91,600,203103,204555,1452,1
183,7,202457,204556,2099,1
19,600,199955,204560,4605,0
190,600,197388,204602,7214,0
5,600,201260,204674,3414,0
119,600,202750,204680,1930,0
30,600,199465,204682,5217,1
95,600,197923,204709,6786,1
47,600,201920,204761,2841,1
138,600,198490,204778,6288,0
169,600,199180,204817,5637,0
45,600,200627,204834,4207,1
40,600,200384,204874,4490,2
161,600,203618,204900,1282,1
189,600,186698,204935,18237,1
29,600,201630,204965,3335,0
145,600,196159,205001,8842,1
14,600,202082,205180,3098,1
61,600,201000,205220,4220,0
124,89,204409,205341,932,1
104,600,198100,205351,7251,0
53,600,201370,205367,3997,0
39,600,202278,205402,3124,1
89,600,201280,205405,4125,0
197,600,198487,205459,6972,1
178,600,201401,205460,4059,1
3,600,200110,205463,5353,0
92,58,202438,205474,3036,1
142,600,200734,205502,4768,1
77,600,203726,205520,1794,1
101,600,202539,205534,2995,1
46,600,202978,205570,2592,1
68,645,201625,205583,3958,2
96,600,198690,205653,6963,0
4,600,200026,205688,5662,1
37,600,203580,205720,2140,0
175,600,200702,205720,5018,1
168,600,199700,205745,6045,0
41,600,201170,205813,4643,1
126,600,202056,205854,3798,0
118,600,203028,205884,2856,0
120,600,202046,206002,3956,1
26,600,202842,206157,3315,1
5,600,205274,206230,956,1
166,131,201701,206231,4530,1
122,600,201361,206349,4988,1
12,600,205057,206386,1329,0
109,600,203468,206407,2939,0
174,600,203050,206553,3503,0
163,600,203490,206571,3081,0
6,600,201680,206622,4942,1
195,600,200450,206629,6179,1
71,600,197804,206674,8870,1
28,600,197851,206746,8895,1
188,39,204209,206760,2551,1
119,600,205280,206850,1570,1
77,89,205609,206854,1245,1
167,9,203939,206906,2967,1
136,600,200720,206975,6255,0
20,600,198668,207009,8341,1
183,600,205156,207023,1867,2
158,600,202090,207044,4954,0
123,128,203878,207048,3170,1
73,600,201060,207070,6010,0
152,600,201686,207230,5544,1
2,600,198047,207490,9443,1
69,600,204137,207562,3425,2
178,0,205460,207570,2110,1
192,600,200060,207579,7519,0
48,600,202372,207586,5214,1
186,600,204424,207613,3189,2
107,600,203360,207656,4296,1
23,600,202877,207679,4802,0
131,600,201520,207705,6185,0
194,600,202730,207788,5058,0
191,600,202057,207840,5783,0
199,600,201955,207912,5957,2
58,600,203489,208017,4528,0
83,600,193273,208030,14757,1
95,600,205309,208060,2751,0
141,600,203789,208129,4340,1
132,600,205290,208143,2853,0
147,600,204207,208164,3957,0
197,600,206059,208235,2176,0
76,600,203960,208277,4317,1
133,600,204414,208361,3947,0
38,600,204130,208399,4269,0
164,600,204990,208429,3439,1
174,600,207153,208480,1327,1
88,600,203720,208590,4870,0
78,600,203111,208590,5479,1
187,600,203052,208644,5592,0
62,600,203836,208766,4930,1
57,600,193248,208836,15588,1
121,600,200873,208840,7967,1
197,600,208835,208920,85,1
7,600,206430,208928,2498,0
94,600,195860,208960,13100,1
196,600,203305,208984,5679,1
1,600,198443,209059,10616,1
157,600,202260,209150,6890,0
113,600,204360,209153,4793,0
75,600,203649,209161,5512,2
90,600,203529,209164,5635,0
193,600,204649,209171,4522,2
41,600,206413,209178,2765,0
158,600,207644,209243,1599,1
160,3219,206349,209327,2978,2
197,267,209187,209405,218,1
24,600,205620,209440,3820,0
71,600,207274,209480,2206,0
82,600,205970,209509,3539,0
148,600,204948,209584,4636,0
43,600,201170,209677,8507,1
105,600,203300,209699,6399,0
124,600,205941,209700,3759,2
92,600,206074,209733,3659,2
97,600,202121,209759,7638,1
108,600,204928,209776,4848,1
12,600,206986,209861,2875,2
96,600,206253,209872,3619,1
87,600,206530,209919,3389,0
163,600,207171,209980,2809,1
37,600,206320,209984,3664,1
135,600,204553,209990,5437,1
101,600,206134,210057,3923,0
195,600,207229,210104,2875,0
31,162,202362,210120,7758,1
166,600,206831,210120,3289,2
47,600,205361,210148,4787,0
29,600,205565,210279,4714,1
167,600,207506,210420,2914,2
128,600,206390,210478,4088,0
116,600,203557,210522,6965,1
136,600,207575,210540,2965,1
152,0,207230,210667,3437,1
176,600,204110,210714,6604,0
185,600,202796,210815,8019,1
126,600,206454,210830,4376,1
165,600,208850,210899,2049,0
71,600,210080,210960,880,1
124,17,209717,210985,1268,2
161,238,205138,211014,5876,1
83,600,208630,211053,2423,0
18,600,203590,211115,7525,0
102,600,195582,211288,15706,1
127,600,205850,211298,5448,0
51,600,200268,211361,11093,1
142,600,207050,211372,4322,0
122,600,206949,211385,4436,0
144,600,200180,211511,11331,0
168,600,206345,211512,5167,1
26,600,206757,211519,4762,0
39,600,206002,211543,5541,0
169,600,205417,211619,6202,1
5,294,206524,211648,5124,1
104,600,205951,211693,5742,1
129,600,202540,211730,9190,0
62,600,209366,211862,2496,0
7,600,209528,211868,2340,1
175,104,205824,212026,6202,1
118,600,206484,212105,5621,1
189,600,205830,212108,6278,0
158,600,209843,212122,2279,0
57,600,209436,212134,2698,0
52,600,201418,212140,10722,1
181,600,203241,212214,8973,1
76,600,208877,212265,3388,0
58,600,208617,212380,3763,1
79,600,204736,212449,7713,0
60,11559,207586,212490,4904,2
50,600,203009,212492,9483,1
2,45,207535,212507,4972,1
134,600,204375,212575,8200,1
36,600,200930,212592,11662,0
143,600,204185,212618,8433,2
3,600,206063,212627,6564,1
47,600,210748,212637,1889,1
74,600,205960,212667,6707,0
113,600,209753,212850,3097,1
95,600,208660,212970,4310,1
78,4,208594,212991,4397,1
166,209,210329,213015,2686,2
46,600,206170,213019,6849,0
169,600,212219,213033,814,0
142,600,211972,213060,1088,1
179,600,206300,213064,6764,0
33,600,205088,213080,7992,1
0,600,206870,213093,6223,0
71,25,210985,213115,2130,1
185,600,211415,213131,1716,0
17,600,206950,213183,6233,0
119,150,207000,213335,6335,1
52,301,212441,213437,996,1
67,600,202046,213475,11429,1
12,600,210461,213545,3084,2
75,2351,211512,213546,2034,2
4,600,206288,213570,7282,0
73,600,207670,213611,5941,1
88,600,209190,213732,4542,1
41,600,209778,213767,3989,1
149,600,201221,213983,12762,1
87,600,210519,214012,3493,1
30,600,206100,214020,7920,0
112,600,203757,214073,10316,2
187,600,209244,214124,4880,1
92,600,210333,214165,3832,1
105,600,210299,214230,3931,1
6,600,207222,214257,7035,2
65,600,204359,214267,9908,0
142,16,213076,214342,1266,1
188,600,207360,214354,6994,2
20,600,207609,214368,6759,0
38,600,208999,214513,5514,1
29,600,210879,214518,3639,0
28,600,209470,214576,5106,0
0,600,213693,214586,893,1
16,600,209180,214587,5407,0
147,600,208764,214608,5844,1
124,600,211585,214626,3041,3
77,600,207454,214905,7451,2
131,600,208305,214947,6642,1
61,600,205820,215000,9180,1
24,600,210040,215041,5001,1
186,600,208213,215047,6834,2
32,600,206500,215063,8563,0
136,132,210672,215089,4417,1
97,600,210359,215133,4774,0
95,92,213062,215210,2148,1
64,600,204490,215210,10720,0
141,600,208810,215307,6497,0
42,600,207440,215311,7871,0
89,600,206005,215334,9329,1
152,600,211267,215367,4100,2
126,300,211130,215448,4318,1
121,268,209108,215450,6342,1
48,600,208570,215479,6909,0
108,600,210376,215562,5186,0
109,600,207007,215571,8564,1
54,600,207780,215582,7802,0
182,600,208990,215588,6598,0
162,600,203200,215610,12410,2
22,600,192799,215612,22813,1
58,1018,213398,215616,2218,1
198,600,202490,215660,13170,0
120,600,206602,215698,9096,0
107,600,208256,215781,7525,0
148,600,210184,215798,5614,1
43,600,210277,215903,5626,0
166,600,213615,215925,2310,3
133,600,208961,215970,7009,1
68,600,206183,215991,9808,2
9,600,203311,216081,12770,1
123,600,207648,216106,8458,2
91,600,206410,216117,9707,0
50,600,213092,216163,3071,0
143,600,213218,216241,3023,1
47,600,213237,216245,3008,0
74,600,213267,216320,3053,1
115,600,207650,216359,8709,0
178,600,208170,216397,8227,2
137,600,208030,216425,8395,0
90,600,209764,216462,6698,1
127,600,211898,216479,4581,1
189,600,212708,216480,3772,1
182,600,216188,216510,322,1
125,600,204191,216512,12321,2
135,25,210015,216691,6676,1
52,600,214037,216715,2678,2
145,600,205640,216720,11080,0
116,600,211122,216759,5637,0
36,600,213192,216781,3589,1
186,600,215647,216967,1320,3
45,600,205434,217045,11611,2
183,600,207623,217091,9468,1
160,600,209927,217092,7165,2
168,600,212112,217102,4990,0
157,600,209750,217205,7455,1
33,600,213680,217342,3662,0
94,284,209244,217395,8151,1
169,600,213633,217418,3785,1
55,4946,204555,217452,12897,2
118,600,212705,217494,4789,0
73,600,214211,217549,3338,0
161,600,211614,217572,5958,2
197,600,210005,217624,7619,2
144,600,212111,217674,5563,1
132,600,208743,217683,8940,1
41,600,214367,217790,3423,0
53,600,205967,217800,11833,1
77,600,215505,217819,2314,1
164,600,209029,217844,8815,0
76,600,212865,217848,4983,1
138,600,205378,217975,12597,1
78,600,213591,217975,4384,2
19,600,205160,217997,12837,1
192,600,208179,218086,9907,1
14,600,206890,218101,11211,0
70,600,204974,218272,13298,1
113,17,212867,218323,5456,1
2,600,213107,218475,5368,2
101,600,210657,218479,7822,1
37,600,210584,218501,7917,0
142,600,214942,218530,3588,2
9,600,216681,218538,1857,0
170,600,202352,218573,16221,1
163,103,210083,218619,8536,1
174,135,208615,218679,10064,1
134,600,213175,218724,5549,0
78,600,218575,218740,165,1
123,600,216706,218780,2074,1
129,600,212330,218831,6501,1
102,600,211888,218840,6952,0
180,600,209030,218850,9820,0
24,600,215641,218855,3214,0
149,600,214583,218874,4291,0
72,600,207110,218893,11783,0
146,600,211870,218901,7031,0
55,600,218052,218914,862,2
171,600,209750,218915,9165,0
42,600,215911,218971,3060,1
172,600,206860,219053,12193,0
82,600,210109,219084,8975,1
69,600,208162,219085,10923,1
1,600,209659,219097,9438,0
11,600,202890,219113,16223,1
83,600,211653,219212,7559,1
0,600,215186,219340,4154,0
99,600,219350,219350,0,0
128,4108,214586,219358,4772,2
103,600,202788,219364,16576,0
175,600,212626,219378,6752,2
79,600,213049,219425,6376,1
81,600,217550,219458,1908,0
109,600,216171,219551,3380,0
121,600,216050,219676,3626,2
23,600,208279,219703,11424,1
190,600,205202,219734,14532,1
40,600,205474,219766,14292,1
67,600,214075,219781,5706,0
57,600,212734,219833,7099,1
50,600,216763,219865,3102,1
179,600,213664,219962,6298,1
90,600,217062,219981,2919,0
58,600,216216,220098,3882,2
93,600,210600,220112,9512,0
167,600,211020,220157,9137,1
153,600,198190,220199,22009,1
135,600,217291,220217,2926,2
126,600,216048,220275,4227,2
81,600,220058,220310,252,1
199,600,208512,220335,11823,1
45,629,217674,220338,2664,2
133,600,216570,220348,3778,0
32,600,215663,220389,4726,1
26,600,212119,220458,8339,1
87,600,214612,220460,5848,0
38,600,215113,220488,5375,0
158,600,212722,220499,7777,1
144,600,218274,220575,2301,0
143,600,216841,220599,3758,0
79,600,220025,220696,671,0
196,600,209584,220779,11195,0
182,140,216650,220810,4160,1
77,600,218419,220846,2427,0
187,600,214724,220871,6147,0
61,600,215600,220885,5285,0
86,600,203813,220980,17167,1
89,600,215934,220987,5053,0
31,600,210720,221112,10392,2
130,600,201610,221209,19599,0
192,600,218686,221336,2650,0
162,600,216210,221371,5161,2
16,600,215187,221515,6328,1
122,600,211985,221519,9534,1
3,600,213227,221530,8303,0
68,790,216781,221531,4750,2
176,600,211314,221549,10235,1
7,600,212468,221607,9139,0
198,600,216260,221607,5347,1
101,600,219079,221652,2573,0
170,600,219173,221788,2615,0
194,600,208388,221824,13436,1
127,600,217079,221989,4910,0
5,600,212248,221995,9747,2
183,600,217691,221999,4308,0
181,600,212814,222008,9194,0
65,600,214867,222062,7195,1
47,600,216845,222067,5222,1
36,600,217381,222162,4781,0
42,600,219571,222192,2621,0
136,600,215689,222289,6600,2
92,600,214765,222341,7576,2
76,600,218448,222443,3995,0
106,600,200794,222464,21670,1
54,600,216182,222479,6297,1
66,600,211380,222480,11100,0
129,600,219431,222539,3108,0
191,4797,212637,222611,9974,2
166,600,216525,222617,6092,2
115,600,216959,222633,5674,1
137,600,217025,222666,5641,1
195,600,210704,222670,11966,1
168,600,217702,222686,4984,1
48,600,216079,222724,6645,1
28,600,215176,222750,7574,1
74,600,216920,222829,5909,0
62,600,212462,222930,10468,1
148,600,216398,223084,6686,0
99,600,219950,223086,3136,1
131,600,215547,223098,7551,0
169,600,218018,223102,5084,2
20,600,214968,223106,8138,1
33,600,217942,223143,5201,1
51,600,211961,223194,11233,0
121,600,220276,223224,2948,1
104,600,212293,223247,10954,0
94,600,217995,223275,5280,2
91,600,216717,223283,6566,1
70,600,220250,223304,3054,0
96,600,210472,223324,12852,0
179,600,220562,223337,2775,0
17,600,213783,223462,9679,1
193,5776,214947,223468,8521,2
19,600,218597,223508,4911,0
175,600,219978,223517,3539,1
11,600,219713,223584,3871,0
139,600,210720,223649,12929,0
52,600,217315,223733,6418,1
173,600,211660,223754,12094,0
130,600,221809,223915,2106,1
124,600,215226,223939,8713,2
85,600,207210,223994,16784,0
119,600,213935,224015,10080,2
147,600,215208,224079,8871,0
63,600,204950,224112,19162,1
182,600,221410,224129,2719,2
88,600,214332,224135,9803,0
132,600,218283,224166,5883,0
34,600,210160,224202,14042,0
185,600,213731,224213,10482,1
102,600,219440,224281,4841,1
197,600,218224,224340,6116,1
138,600,218575,224367,5792,0
12,600,214145,224377,10232,2
86,600,221580,224418,2838,0
31,600,221712,224493,2781,2
158,600,221099,224556,3457,0
4,600,214170,224566,10396,1
157,600,217805,224661,6856,0
98,600,209520,224726,15206,0
43,600,216503,224808,8305,1
56,600,214220,224822,10602,0
150,600,200603,224832,24229,1
123,600,219380,224905,5525,0
55,600,219514,224930,5416,2
186,600,217567,224951,7384,2
30,600,214620,225020,10400,1
101,600,222252,225022,2770,1
175,600,224117,225077,960,2
24,600,219455,225114,5659,1
144,600,221175,225170,3995,1
106,600,223064,225224,2160,0
174,600,219279,225262,5983,2
65,600,222662,225335,2673,0
105,146,214376,225394,11018,1
127,600,222589,225410,2821,1
57,600,220433,225464,5031,0
178,600,216997,225499,8502,1
49,600,216380,225528,9148,0
95,600,215810,225542,9732,2
83,600,219812,225567,5755,0
67,600,220381,225573,5192,1
151,600,217420,225574,8154,0
172,600,219653,225581,5928,1
159,600,192162,225649,33487,1
2,600,219075,225653,6578,1
141,600,215907,225704,9797,1
122,600,222119,225817,3698,0
97,600,215733,225823,10090,1
101,600,225622,225898,276,0
133,600,220948,225913,4965,1
50,600,220465,225973,5508,0
78,91,218831,226047,7216,1
176,600,222149,226056,3907,0
23,600,220303,226186,5883,0
107,600,216381,226248,9867,1
113,600,218923,226252,7329,2
189,142,216622,226291,9669,1
190,600,220334,226311,5977,0
118,600,218094,226355,8261,1
38,600,221088,226360,5272,1
116,600,217359,226489,9130,1
46,600,213619,226572,12953,1
108,600,216162,226597,10435,1
146,600,219501,226603,7102,1
130,600,224515,226637,2122,0
53,600,218400,226655,8255,0
194,600,222424,226729,4305,0
100,600,214840,226745,11905,0
144,600,225770,226757,987,0
80,600,217150,226766,9616,0
48,600,223324,226785,3461,0
193,600,224068,226799,2731,2
71,600,213715,226805,13090,2
39,600,212143,226846,14703,1
89,600,221587,226997,5410,1
18,600,211715,227017,15302,1
33,600,223743,227039,3296,0
26,600,221058,227044,5986,0
94,600,223875,227046,3171,1
161,600,218172,227094,8922,1
61,600,221485,227110,5625,1
17,600,224062,227153,3091,0
162,691,222062,227200,5138,2
105,600,225994,227204,1210,2
178,600,226099,227215,1116,0
115,600,223233,227234,4001,1
64,5179,220389,227351,6962,2
136,600,222889,227430,4541,1
185,600,224813,227445,2632,0
91,600,223883,227470,3587,0
102,600,224881,227510,2629,0
198,600,222207,227521,5314,0
93,600,220712,227579,6867,1
164,600,218444,227605,9161,1
14,600,218701,227605,8904,1
10,600,216570,227675,11105,0
197,600,224940,227718,2778,0
152,600,215967,227794,11827,1
45,1486,221824,227806,5982,2
170,600,222388,227826,5438,1
142,600,219130,227856,8726,1
163,600,219219,227943,8724,2
55,600,225530,228003,2473,1
82,600,219684,228003,8319,2
6,3543,217800,228018,10218,2
69,600,219685,228121,8436,0
85,600,224594,228157,3563,1
187,600,221471,228192,6721,1
87,600,221060,228283,7223,1
75,600,214146,228297,14151,1
9,600,219138,228303,9165,1
43,600,225408,228336,2928,0
29,600,215118,228399,13281,1
97,600,226423,228432,2009,0
73,600,218149,228437,10288,1
108,600,227197,228510,1313,0
137,600,223266,228532,5266,0
103,600,219964,228536,8572,1
5,600,222595,228592,5997,1
131,600,223698,228601,4903,1
188,600,214954,228697,13743,1
160,600,217692,228698,11006,1
28,77,222827,228718,5891,1
31,2524,227017,228762,1745,2
61,600,227710,228841,1131,0
168,600,223286,228850,5564,0
132,600,224766,228891,4125,1
92,600,222941,228988,6047,1
123,600,225505,229027,3522,1
112,600,214673,229056,14383,1
142,600,228456,229126,670,0
171,600,219515,229238,9723,1
42,600,222792,229276,6484,1
20,600,223706,229308,5602,0
172,600,226181,229332,3151,0
143,600,221199,229546,8347,1
117,600,218100,229559,11459,0
141,600,226304,229621,3317,0
174,600,225862,229632,3770,1
32,600,220989,229647,8658,0
164,600,228205,229748,1543,0
16,600,222115,229829,7714,0
21,600,216420,229836,13416,0
0,600,219940,229863,9923,1
133,600,226513,229903,3390,0
199,600,220935,229973,9038,0
67,600,226173,229979,3806,0
86,600,225018,230038,5020,1
162,600,227800,230066,2266,1
127,35,225445,230094,4649,1
18,600,227617,230103,2486,0
167,600,220757,230138,9381,0
1,600,219697,230204,10507,1
31,600,229362,230220,858,1
184,600,215020,230252,15232,0
173,600,224354,230326,5972,1
41,600,218390,230443,12053,1
5,600,229192,230486,1294,0
153,600,221180,230510,9330,0
4,600,225166,230587,5421,0
125,600,217112,230619,13507,1
58,600,220698,230656,9958,1
7,600,222207,230666,8459,1
161,600,227694,230667,2973,0
54,600,223079,230689,7610,0
47,600,222667,230758,8091,2
150,600,225432,230857,5425,0
72,600,219493,231002,11509,1
89,600,227597,231031,3434,0
158,600,225156,231223,6067,1
160,600,229298,231247,1949,0
149,600,219474,231280,11806,1
155,600,212440,231347,18907,0
55,600,228603,231421,2818,0
187,600,228792,231445,2653,0
129,600,223139,231455,8316,1
100,600,227345,231485,4140,1
14,600,228205,231507,3302,0
120,600,216298,231516,15218,1
62,600,223530,231529,7999,1
188,600,229297,231545,2248,0
78,600,226647,231643,4996,2
12,600,224977,231692,6715,1
154,600,216570,231787,15217,0
87,600,228883,231804,2921,0
113,600,226852,231866,5014,1
36,600,222762,231894,9132,1
71,600,227405,231922,4517,1
175,600,225677,231974,6297,1
34,600,224802,232106,7304,1
28,600,229318,232113,2795,2
134,600,219324,232195,12871,1
95,600,226142,232210,6068,1
146,600,227203,232295,5092,0
121,600,223824,232311,8487,0
179,600,223937,232366,8429,1
9,600,228903,232420,3517,0
151,600,226174,232449,6275,1
165,600,211499,232488,20989,1
61,600,229441,232568,3127,1
29,600,228999,232661,3662,0
23,600,226786,232683,5897,1
135,600,220817,232719,11902,1
2,600,226253,232770,6517,2
3,600,222130,232780,10650,1
170,600,228426,232809,4383,0
198,600,228121,232838,4717,1
191,600,223211,232852,9641,2
80,600,227366,232880,5514,1
60,600,213090,232947,19857,1
123,600,229627,233072,3445,0
37,600,219101,233104,14003,1
93,600,228179,233136,4957,0
68,600,222131,233248,11117,1
41,600,231043,233281,2238,0
27,600,218360,233311,14951,0
186,600,225551,233316,7765,1
26,600,227644,233323,5679,1
51,600,223794,233341,9547,1
24,600,225714,233394,7680,0
69,600,228721,233402,4681,1
125,600,231219,233432,2213,0
118,600,226955,233514,6559,0
140,600,219960,233552,13592,0
190,600,226911,233589,6678,1
35,600,218060,233658,15598,0
179,600,232966,233670,704,0
42,600,229876,233681,3805,0
30,600,225620,233701,8081,0
19,600,224108,233759,9651,1
145,600,217320,233806,16486,1
114,600,226110,233806,7696,0
57,600,226064,233823,7759,1
136,600,228030,233828,5798,0
16,600,230429,233878,3449,1
195,600,223270,233947,10677,0
142,600,229726,234011,4285,1
79,600,221296,234011,12715,1
130,600,227237,234081,6844,1
106,600,225824,234153,8329,1
59,600,221010,234188,13178,0
58,600,231256,234215,2959,0
66,600,223080,234241,11161,1
110,600,222220,234285,12065,0
189,600,226891,234295,7404,2
75,600,228897,234334,5437,0
116,600,227089,234424,7335,0
194,600,227329,234478,7149,1
122,600,226417,234529,8112,1
76,600,223043,234547,11504,1
33,600,227639,234564,6925,1
45,600,228406,234582,6176,1
86,600,230638,234662,4024,0
112,600,229656,234669,5013,0
39,600,227446,234774,7328,0
104,600,223847,234782,10935,1
0,600,230463,234835,4372,0
169,600,223702,234900,11198,1
44,600,216500,234942,18442,0
120,600,232116,234963,2847,0
85,600,228757,234967,6210,0
163,600,228543,234975,6432,1
36,600,232494,235039,2545,0
74,600,223429,235107,11678,1
171,600,229838,235189,5351,0
43,600,228936,235224,6288,1
2,600,233370,235250,1880,1
159,600,226249,235312,9063,0
107,600,226848,235377,8529,0
1,600,230804,235392,4588,0
181,600,222608,235489,12881,1
147,600,224679,235502,10823,1
101,600,226498,235505,9007,1
100,600,232085,235572,3487,0
132,600,229491,235595,6104,0
84,600,213510,235683,22173,0
177,600,222290,235743,13453,0
91,600,228070,235781,7711,1
126,600,220875,235896,15021,1
143,600,230146,235948,5802,0
31,600,230820,235952,5132,0
173,600,230926,235999,5073,0
23,600,233283,236099,2816,0
133,600,230503,236103,5600,1
182,600,224729,236110,11381,1
109,600,220151,236115,15964,1
22,600,221210,236118,14908,0
43,600,235824,236150,326,0
196,600,221379,236151,14772,1
193,600,227399,236258,8859,1
81,298,220608,236325,15717,1
5,600,231086,236395,5309,1
108,600,229110,236470,7360,1
7,600,231266,236473,5207,0
91,600,236381,236551,170,0
72,600,231602,236575,4973,0
161,600,231267,236627,5360,1
77,600,221446,236668,15222,1
9,600,233020,236681,3661,1
64,806,228157,236734,8577,2
70,600,223904,236752,12848,1
98,600,225326,236792,11466,1
57,600,234423,236872,2449,0
127,600,230694,236887,6193,2
119,600,224615,236919,12304,1
163,600,235575,236921,1346,0
60,600,233547,236997,3450,0
73,600,229037,237087,8050,0
48,600,227385,237123,9738,1
37,600,233704,237154,3450,0
117,600,230159,237157,6998,1
62,600,232129,237166,5037,2
46,600,227172,237226,10054,0
157,600,225261,237304,12043,1
6,600,228618,237306,8688,3
198,600,233438,237326,3888,0
178,600,227815,237343,9528,1
3,600,233380,237419,4039,0
8,600,220360,237422,17062,0
69,600,234002,237456,3454,0
11,600,224184,237461,13277,1
95,600,232810,237599,4789,0
187,600,232045,237599,5554,1
167,600,230738,237628,6890,1
63,600,224712,237638,12926,0
65,600,225935,237833,11898,1
142,600,234611,237878,3267,0
51,600,233941,237897,3956,0
24,600,233994,237921,3927,1
197,600,228318,237940,9622,1
152,600,228394,237989,9595,0
131,600,229201,238004,8803,0
194,600,235078,238015,2937,0
134,600,232795,238066,5271,0
175,600,232574,238224,5650,0
56,600,225422,238317,12895,1
149,600,231880,238323,6443,0
10,600,228275,238328,10053,1
153,600,231110,238338,7228,1
105,600,227804,238385,10581,1
199,600,230573,238423,7850,1
103,600,229136,238512,9376,0
27,600,233911,238565,4654,1
184,600,230852,238628,7776,1
82,600,228603,238668,10065,1
135,600,233319,238703,5384,0
118,600,234114,238777,4663,1
66,600,234841,238824,3983,0
54,600,231289,238835,7546,1
124,600,224539,238836,14297,1
191,600,233452,238888,5436,1
157,600,237904,238951,1047,0
78,600,232243,238982,6739,1
130,600,234681,239015,4334,0
61,600,233168,239051,5883,0
34,600,232706,239113,6407,0
21,600,230436,239168,8732,1
168,600,229450,239184,9734,1
183,600,222599,239194,16595,1
19,600,234359,239220,4861,0
101,600,236105,239249,3144,0
185,600,228045,239255,11210,1
98,600,237392,239293,1901,0
18,600,230703,239342,8639,1
174,600,230232,239374,9142,0
197,600,238540,239408,868,0
32,600,230247,239545,9298,1
96,600,223924,239592,15668,1
176,600,226656,239631,12975,1
166,600,223217,239634,16417,1
125,600,234032,239694,5662,1
94,600,227646,239698,12052,2
40,600,220366,239714,19348,0
89,600,231631,239739,8108,1
162,600,230666,239756,9090,0
116,600,235024,239783,4759,1
88,600,224735,239804,15069,1
133,600,236703,239819,3116,0
83,600,226167,239855,13688,1
180,600,219450,239900,20450,1
172,600,229932,239955,10023,1
12,600,232292,239962,7670,0
184,600,239228,240004,776,0
137,600,229132,240063,10931,1
113,600,232466,240084,7618,0
68,600,233848,240093,6245,0
190,600,234189,240173,5984,0
67,600,230579,240274,9695,1
92,600,229588,240383,10795,0
29,600,233261,240773,7512,1
80,600,233480,240783,7303,0
90,600,220581,240907,20326,1
97,600,229032,240933,11901,1
2,600,235850,240979,5129,0
104,600,235382,240985,5603,0
115,600,227834,241036,13202,0
102,600,228110,241089,12979,1
50,600,226573,241256,14683,1
62,600,237766,241345,3579,1
86,600,235262,241367,6105,1
14,600,232107,241373,9266,1
141,600,230221,241380,11159,1
58,600,234815,241388,6573,1
99,600,225870,241663,15793,0
38,600,226960,241675,14715,0
173,600,236599,241718,5119,1
165,600,233088,241841,8753,0
193,600,236858,242008,5150,0
20,600,229908,242010,12102,1
119,600,237519,242063,4544,0
75,600,234934,242107,7173,1
128,600,219958,242109,22151,1
39,600,235374,242125,6751,1
186,600,233916,242203,8287,0
60,600,237597,242316,4719,1
143,600,236548,242343,5795,1
109,600,236715,242381,5666,0
152,600,238589,242410,3821,1
6,600,237906,242521,4615,1
66,600,239424,242560,3136,1
198,600,237926,242660,4734,1
87,600,232404,242709,10305,1
146,600,232895,242887,9992,1
19,600,239820,242940,3120,1
171,600,235789,242940,7151,1
0,600,235435,242981,7546,1
192,600,221936,243156,21220,1
177,600,236343,243393,7050,1
144,600,227357,243424,16067,1
31,600,236552,243733,7181,1
53,600,227255,243886,16631,1
75,600,242707,243893,1186,0
142,600,238478,244030,5552,1
107,600,235977,244117,8140,1
125,600,240294,244145,3851,0
59,600,234788,244186,9398,1
35,600,234258,244264,10006,1
139,600,224249,244353,20104,1
3,600,238019,244354,6335,1
154,600,232387,244455,12068,1
150,600,231457,244537,13080,1
155,600,231947,244540,12593,1
145,600,234406,244541,10135,0
127,600,237487,244802,7315,1
91,600,237151,244841,7690,1
147,600,236102,244875,8773,0
148,600,223684,244928,21244,1
23,600,236699,244955,8256,1
159,600,235912,244995,9083,1
43,600,236750,245105,8355,1
42,600,234281,245166,10885,1
61,600,239651,245193,5542,1
55,600,232021,245196,13175,1
17,600,227753,245249,17496,1
57,600,237472,245263,7791,1
47,600,231358,245387,14029,1
103,600,239112,245422,6310,1
51,600,238497,245443,6946,1
138,600,224967,245498,20531,1
169,600,235500,245565,10065,0
131,600,238604,245581,6977,1
149,600,238923,245629,6706,1
100,600,236172,245724,9552,1
136,600,234428,245895,11467,1
34,600,239713,246092,6379,1
33,600,235164,246257,11093,0
188,600,232145,246406,14261,1
73,600,237687,246412,8725,1
194,600,238615,246516,7901,1
119,600,242663,246551,3888,1
37,600,237754,246708,8954,1
41,600,233881,246713,12832,1
28,600,232713,246901,14188,1
120,600,235563,246920,11357,1
46,600,237826,247351,9525,1
132,600,236195,247392,11197,1
189,600,234895,247495,12600,1
63,600,238238,247659,9421,1
197,600,240008,247792,7784,1
81,600,236925,247853,10928,2
95,600,238199,247943,9744,1
140,600,234152,247998,13846,1
123,600,233672,248113,14441,1
134,600,238666,248156,9490,1
157,600,239551,248266,8715,1
163,600,237521,248529,11008,1
133,600,240419,248581,8162,1
174,600,239974,248640,8666,1
70,600,237352,248750,11398,2
113,600,240684,248890,8206,1
184,600,240604,248935,8331,1
164,600,230348,248937,18589,1
104,600,241585,249038,7453,1
160,600,231847,249078,17231,1
1,600,235992,249298,13306,1
85,600,235567,249321,13754,1
125,600,244745,249398,4653,1
94,600,240298,249560,9262,1
44,600,235542,249685,14143,1
4,600,231187,249727,18540,1
80,600,241383,250171,8788,1
36,600,235639,250202,14563,1
84,600,236283,250298,14015,1
101,600,239849,250309,10460,1
22,600,236718,250456,13738,1
193,600,242608,250520,7912,1
93,600,233736,250693,16957,1
121,600,232911,250998,18087,1
69,600,238056,251342,13286,1
64,600,237334,251458,14124,1
114,600,234406,251469,17063,1
12,600,240562,251626,11064,1
68,600,240693,251674,10981,1
112,600,235269,251701,16432,1
195,600,234547,251790,17243,1
30,600,234301,251799,17498,1
38,600,242275,251822,9547,1
109,600,242981,251837,8856,1
2,600,241579,251884,10305,1
175,600,238824,252063,13239,1
8,600,238022,252102,14080,1
49,600,226128,252404,26276,1
110,600,234885,252551,17666,1
135,600,239303,252735,13432,1
75,600,244493,253050,8557,1
99,600,242263,253798,11535,1
70,648,249398,253817,4419,2
162,600,240356,253836,13480,1
40,600,240314,254353,14039,1
130,600,239615,254443,14828,1
46,600,247951,255014,7063,0
186,600,242803,255095,12292,1
7,600,237073,255450,18377,1
190,600,240773,255646,14873,1
98,600,239893,255910,16017,1
179,600,234270,256327,22057,1
165,600,242441,256986,14545,1
72,600,237175,257862,20687,1
81,787,248640,258283,9643,2
46,600,255614,258917,3303,1
145,600,245141,259762,14621,1
147,600,245475,260467,14992,1
70,600,254417,261054,6637,1
115,600,241636,261524,19888,1
170,600,233409,264583,31174,1
33,600,246857,266097,19240,1
81,634,258917,267382,8465,2
81,600,267982,269144,1162,1
92,600,240983,272152,31169,1
169,600,246165,278290,32125,1
